S..############################
...............#.....#..#..#..#
#..#..##########..####..#..#..#
#..#...........#........#.....#
####..#..####..#..####..#..#..#
#.....#..#.....#..#........#..#
#..#..#######..#######..####..#
#..#.....#.................#..#
#..#..#######..################
#..#.....#..#..#.....#........#
####..####..####..#..####..####
#.....#.....#.....#..#........#
#..#######..#..#..#..#..####..#
#..#..#.....#..#..#........#..#
#..#..#..####..####..#######..#
#.....#........#..#........#..#
#..####..#######..####..####..#
#.....#..#...........#..#..#..#
####..#..####..##########..#..#
#.......................#.....E
############################EEE