S..##########################################################
......#..............#........#..#........#..#.....#........#
#..####..#..####..#..####..####..#..####..#..#..#..#..#######
#........#..#.....#..#.....#.....#..#........#..#..#........#
#..#######..#######..####..####..##########..#..####..#######
#..#..#..#..#.....#..#....................#........#.....#..#
#..#..#..#######..#..#..#######..####..##########..#..####..#
#........#....................#.....#..#.....#........#.....#
##########..#..####..#..#############..#..#..#..#..####..####
#...........#..#.....#..#.................#..#..#..#.....#..#
#..####..#############..#..####..####..#######..#..####..#..#
#.....#.....#..#........#..#........#..#..#..#..#........#..#
####..#..####..#######..#######..#..#..#..#..####..####..#..#
#..#..#.....#.................#..#..#..............#..#.....#
#..#..####..#######..#######..####..#############..#..####..#
#..#..#..#..#..............#.....#........#..#..#..#..#..#..#
#..#..#..####..#############..#..##########..#..####..#..#..#
#........#..#.....#.....#..#..#..#..#..#....................#
##########..#..####..#..#..#..####..#..##########..#..#..####
#...........#........#.....#..#.....#..............#..#.....#
#..####..#######..#######..#######..#..####..##########..#..#
#.....#.....#.....#.....#..#..#........#...........#.....#..#
####..#######..#..####..#..#..#..#############..#..#..#######
#...........#..#..#........#..............#.....#..#..#.....#
#..####..####..######################..#..#..####..#..#..#..#
#..#....................#........#.....#..#.....#..#.....#..#
#..##########..##########..####..#..####..####..#..#..#######
#...........#..#........#.....#..#..#..#..#.....#..#..#.....#
####..##########..#######..#######..#..#############..#..#..#
#.....#.................#..#.....#..#.....#........#.....#..#
#..################..#..#..#..####..#..#..#..##########..#..#
#.....#..#........#..#.....#.....#.....#..#..#...........#..#
#..#..#..#..#..#..#..#..####..#############..####..####..#..#
#..#........#..#.....#..#........#..#..#..#........#..#..#..#
#..#############..##########..#..#..#..#..##########..#######
#..#.................#.....#..#........#..............#.....#
#############..####..#..#############..#..#######..#######..#
#.....#..#.....#........#..#..#..#........#.....#..#..#.....#
#..####..#..####..#######..#..#..#..####..####..####..#..####
#..............#.......................#....................E
##########################################################EEE