S..###########################################
.........#..............#..#.................#
#..#..####..#..#######..#..#..####..#..####..#
#..#..#..#..#..#...........#..#.....#..#..#..#
#..####..################..####..#..####..####
#........#.....#.....#..#........#..#........#
#..#..####..####..#..#..#######..#######..####
#..#..#.....#.....#..#..#........#.....#..#..#
#..####..####..#..#..#..#######..####..#..#..#
#...........#..#..#..#.......................#
#..#############..#..#..###################..#
#...........#.....#..#.....#..#.....#........#
#..#######..#..####..#..####..#..#..#######..#
#..#..#.....#.....#..............#..#........#
####..#..#..####..#..####..####..#######..#..#
#........#..#.....#.....#..#..#..#........#..#
#..#..##########..#######..#..#..#..####..#..#
#..#........#..#.....#........#..#.....#..#..#
#..#..####..#..#..#..#######..####..####..####
#..#..#...........#........#..#.....#........#
#..#..####..###################..#..#..####..#
#..#..#..#..#..#.....#........#..#..#.....#..#
####..#..#..#..#..####..#######..#..##########
#........#..#.................#..#.....#.....#
#..####..#..####..####..####..####..####..####
#..#.....#..#..#..#..#.....#..#........#.....#
#######..####..#..#..################..####..#
#.....#..#..............#..#.....#..#........#
#..####..#..#############..#..####..#..#..#..#
#.......................#..............#..#..E
###########################################EEE